NO textures/tile1.xpm
SO textures/tile2.xpm
EA textures/tile3.xpm

F 72,78,255
C 56,89,34

WE textures/tile3.xpm






        1111111111 11111111111111
        1000000001110000000000001
        1011000001010000000000001
        1001000000000000000000001
111111111011000001110000000000001
10000000001100000111011111111111
11110111111111011100000010001
11110111111111011101010010001
11000000110101011100000010001
10000000000111100000110011001
100000111001  101101010010001
1100000111011111110111100N111
11110111 1110101 101111010001
11111111 1111111 1111 1111111


111111111    11111   11
100000011  1111001
1111111111   11111

         11111
         10001
         11111
